[{
        "id": 0,
        "author": "雅婷",
        "map": [
            [0, 2, 0, 1, 0, 0, 1, 1, 0, 1, 1, 0, 1, 1, 1, 1, 0, 0, 0, 0],
            [0, 2, 1, 1, 1, 1, 0, 0, 1, 1, 0, 0, 1, 0, 1, 0, 0, 0, 1, 1],
            [1, 2, 1, 1, 1, 1, 0, 0, 0, 1, 0, 1, 1, 0, 0, 0, 1, 1, 0, 0],
            [0, 2, 0, 0, 0, 1, 1, 0, 1, 1, 0, 0, 0, 0, 0, 0, 1, 1, 1, 0],
            [1, 2, 1, 0, 1, 0, 0, 0, 0, 0, 1, 1, 0, 0, 0, 0, 1, 0, 1, 0],
            [1, 2, 0, 0, 0, 1, 0, 0, 0, 0, 0, 0, 0, 1, 1, 1, 0, 0, 0, 1],
            [0, 2, 0, 0, 0, 1, 1, 0, 1, 0, 0, 1, 1, 1, 0, 0, 0, 1, 0, 1],
            [0, 2, 0, 0, 0, 1, 0, 0, 1, 1, 0, 1, 0, 0, 1, 1, 0, 1, 1, 0],
            [0, 2, 1, 1, 1, 0, 1, 0, 1, 1, 1, 0, 0, 1, 1, 0, 0, 0, 0, 0],
            [0, 2, 1, 0, 1, 0, 0, 1, 0, 1, 0, 0, 1, 0, 0, 1, 0, 0, 0, 1],
            [1, 2, 1, 0, 0, 1, 1, 0, 1, 1, 0, 1, 1, 1, 0, 0, 0, 1, 1, 0],
            [0, 2, 1, 1, 0, 0, 0, 0, 0, 1, 1, 0, 1, 0, 0, 1, 0, 0, 1, 1],
            [2, 2, 2, 2, 2, 2, 2, 2, 2, 0, 0, 0, 1, 0, 0, 0, 0, 0, 1, 1],
            [1, 2, 1, 0, 1, 1, 0, 0, 2, 0, 1, 0, 0, 1, 0, 0, 0, 1, 0, 0],
            [0, 0, 0, 0, 1, 0, 1, 0, 2, 1, 1, 1, 0, 0, 0, 1, 0, 1, 0, 0],
            [0, 0, 1, 0, 0, 1, 1, 1, 2, 0, 0, 0, 0, 0, 1, 0, 1, 0, 0, 0],
            [1, 0, 0, 1, 0, 1, 0, 0, 2, 1, 1, 0, 1, 0, 1, 1, 0, 0, 0, 1],
            [0, 1, 1, 0, 0, 0, 0, 0, 2, 0, 1, 0, 1, 1, 1, 1, 1, 1, 0, 0],
            [1, 0, 1, 0, 0, 2, 2, 2, 2, 1, 0, 1, 0, 0, 0, 1, 0, 1, 0, 0],
            [0, 0, 1, 1, 1, 2, 1, 1, 1, 1, 1, 0, 0, 0, 0, 1, 0, 0, 1, 1],
            [0, 1, 0, 0, 1, 2, 1, 1, 1, 0, 1, 1, 1, 0, 1, 1, 1, 1, 1, 1],
            [0, 0, 0, 0, 0, 2, 2, 2, 2, 2, 0, 1, 1, 0, 1, 1, 0, 1, 1, 0],
            [0, 0, 0, 0, 1, 2, 1, 0, 0, 2, 0, 0, 0, 0, 0, 0, 1, 0, 1, 1],
            [1, 0, 0, 1, 1, 1, 1, 1, 0, 2, 0, 0, 1, 1, 0, 0, 0, 0, 0, 0],
            [0, 0, 0, 0, 1, 1, 1, 0, 0, 2, 0, 0, 0, 1, 1, 1, 0, 0, 0, 0],
            [1, 0, 1, 1, 1, 1, 1, 0, 1, 2, 1, 0, 0, 0, 0, 0, 0, 0, 0, 1],
            [1, 1, 0, 0, 0, 1, 1, 0, 0, 2, 0, 0, 1, 0, 1, 0, 0, 1, 0, 0],
            [0, 1, 0, 0, 1, 1, 1, 1, 0, 2, 2, 2, 2, 2, 2, 2, 2, 2, 0, 1],
            [1, 1, 0, 0, 1, 0, 0, 1, 0, 0, 0, 1, 1, 1, 1, 1, 1, 2, 0, 0],
            [1, 0, 1, 1, 1, 0, 0, 1, 1, 1, 0, 1, 0, 0, 1, 0, 0, 2, 0, 0],
            [0, 1, 0, 0, 0, 0, 0, 0, 0, 0, 0, 0, 0, 1, 0, 0, 0, 2, 1, 0],
            [1, 1, 0, 0, 1, 1, 0, 1, 1, 1, 0, 0, 0, 0, 1, 1, 0, 2, 0, 1],
            [0, 1, 1, 1, 0, 0, 0, 1, 1, 0, 0, 1, 1, 0, 1, 1, 1, 2, 0, 0],
            [0, 0, 1, 0, 1, 0, 0, 0, 1, 1, 0, 0, 0, 0, 0, 0, 0, 2, 0, 0],
            [0, 0, 1, 0, 1, 0, 1, 0, 1, 1, 1, 0, 0, 0, 0, 1, 1, 2, 0, 0],
            [1, 0, 0, 0, 0, 0, 1, 1, 0, 0, 0, 0, 1, 1, 1, 2, 2, 2, 1, 0],
            [0, 1, 0, 0, 0, 1, 1, 1, 1, 0, 0, 0, 0, 1, 0, 2, 2, 0, 0, 1],
            [0, 0, 0, 0, 0, 1, 0, 1, 1, 1, 1, 1, 0, 1, 1, 0, 2, 2, 2, 2],
            [0, 0, 0, 0, 0, 0, 0, 0, 0, 0, 0, 1, 0, 0, 0, 1, 1, 0, 0, 2],
            [0, 1, 1, 0, 0, 1, 1, 1, 0, 0, 0, 0, 1, 0, 1, 0, 0, 1, 0, 0]
        ]
    },
    {
        "id": 1,
        "author": "雅婷",
        "map": [
            [9, 2, 1, 1, 1, 1, 1, 1, 0, 1, 0, 0, 1, 0, 0, 1, 0, 0, 1, 0],
            [0, 2, 0, 0, 0, 0, 0, 1, 0, 1, 1, 1, 1, 0, 0, 1, 1, 1, 1, 1],
            [0, 2, 0, 1, 1, 1, 1, 0, 0, 0, 0, 0, 0, 0, 0, 0, 1, 0, 1, 0],
            [0, 2, 0, 1, 1, 1, 0, 1, 1, 1, 1, 0, 1, 1, 1, 1, 0, 1, 0, 0],
            [0, 2, 0, 1, 0, 1, 0, 1, 1, 0, 0, 1, 1, 0, 0, 0, 1, 1, 0, 1],
            [1, 2, 2, 2, 1, 0, 1, 1, 1, 0, 1, 0, 0, 1, 1, 0, 1, 1, 1, 0],
            [0, 2, 1, 2, 0, 0, 1, 0, 0, 0, 0, 0, 0, 1, 1, 1, 0, 1, 1, 0],
            [1, 0, 1, 2, 0, 1, 0, 0, 1, 0, 1, 1, 0, 1, 1, 1, 0, 0, 0, 0],
            [0, 1, 2, 2, 1, 0, 1, 1, 0, 1, 0, 0, 1, 1, 1, 1, 0, 0, 0, 1],
            [0, 0, 2, 1, 1, 1, 0, 0, 1, 0, 0, 1, 0, 0, 0, 0, 1, 0, 0, 1],
            [0, 1, 2, 1, 2, 1, 0, 0, 0, 0, 0, 0, 1, 0, 0, 0, 1, 1, 1, 1],
            [0, 0, 2, 2, 2, 1, 0, 1, 0, 1, 0, 0, 0, 0, 0, 0, 0, 1, 1, 1],
            [1, 1, 1, 0, 2, 2, 2, 0, 0, 0, 0, 1, 1, 1, 1, 1, 0, 0, 0, 1],
            [0, 1, 1, 0, 1, 1, 2, 1, 1, 0, 1, 0, 1, 1, 0, 0, 1, 0, 0, 0],
            [1, 1, 0, 1, 0, 1, 2, 2, 2, 1, 1, 0, 1, 1, 0, 0, 1, 1, 0, 1],
            [0, 0, 0, 1, 1, 0, 0, 1, 2, 1, 0, 0, 1, 1, 0, 1, 0, 1, 0, 1],
            [0, 1, 1, 0, 1, 0, 0, 1, 2, 0, 1, 0, 0, 1, 1, 1, 0, 0, 0, 1],
            [0, 0, 2, 2, 2, 2, 2, 2, 2, 0, 1, 0, 1, 1, 1, 1, 1, 1, 0, 1],
            [1, 1, 2, 1, 1, 0, 1, 1, 0, 0, 0, 0, 0, 0, 1, 1, 1, 1, 0, 1],
            [0, 1, 2, 0, 0, 1, 0, 1, 0, 1, 0, 0, 1, 1, 1, 1, 1, 1, 0, 1],
            [0, 1, 2, 0, 0, 1, 0, 0, 0, 0, 1, 1, 1, 0, 0, 0, 0, 1, 0, 1],
            [1, 0, 2, 0, 1, 1, 0, 1, 1, 1, 1, 1, 1, 1, 0, 0, 1, 1, 1, 1],
            [0, 1, 2, 2, 2, 2, 2, 1, 0, 1, 1, 0, 1, 0, 1, 1, 1, 1, 1, 1],
            [1, 1, 0, 0, 0, 1, 2, 0, 0, 1, 1, 0, 1, 0, 0, 0, 1, 0, 0, 0],
            [1, 1, 1, 1, 1, 0, 2, 2, 2, 1, 1, 0, 0, 1, 1, 0, 1, 1, 0, 0],
            [0, 0, 0, 0, 1, 0, 0, 0, 2, 1, 0, 1, 1, 0, 1, 1, 1, 1, 1, 0],
            [1, 1, 1, 0, 1, 1, 0, 1, 2, 0, 1, 0, 0, 0, 1, 1, 0, 0, 1, 1],
            [0, 1, 1, 0, 0, 0, 1, 0, 2, 2, 1, 0, 0, 0, 0, 0, 0, 1, 1, 1],
            [1, 0, 1, 1, 0, 1, 0, 0, 2, 2, 2, 2, 2, 1, 0, 0, 0, 0, 0, 1],
            [1, 0, 1, 1, 0, 0, 0, 1, 1, 0, 0, 2, 2, 0, 1, 1, 1, 1, 1, 0],
            [0, 0, 0, 0, 0, 1, 1, 0, 0, 0, 0, 1, 2, 1, 0, 0, 1, 0, 1, 0],
            [0, 1, 0, 1, 0, 1, 0, 1, 1, 1, 1, 0, 2, 0, 1, 0, 0, 1, 1, 0],
            [1, 0, 1, 0, 0, 1, 0, 1, 1, 1, 0, 1, 2, 2, 2, 1, 0, 0, 0, 1],
            [0, 1, 0, 1, 1, 1, 1, 1, 1, 0, 0, 0, 0, 0, 2, 0, 0, 1, 0, 1],
            [1, 0, 1, 0, 0, 0, 0, 0, 0, 1, 0, 1, 0, 0, 2, 1, 1, 1, 0, 0],
            [0, 1, 0, 1, 1, 0, 0, 0, 1, 1, 1, 0, 1, 1, 2, 1, 1, 1, 0, 0],
            [0, 1, 1, 1, 1, 1, 0, 0, 1, 0, 1, 0, 0, 1, 2, 2, 2, 2, 1, 1],
            [0, 0, 1, 1, 1, 0, 0, 1, 1, 1, 1, 1, 0, 0, 1, 0, 0, 2, 0, 1],
            [0, 1, 1, 0, 1, 0, 1, 1, 1, 0, 0, 0, 0, 0, 1, 0, 1, 2, 1, 0],
            [1, 0, 0, 0, 0, 1, 0, 1, 0, 1, 0, 1, 1, 1, 1, 1, 1, 2, 2, 2]
        ]
    },
    {
        "id": 2,
        "author": "雅婷",
        "map": [
            [9, 2, 1, 1, 0, 1, 1, 1, 1, 0, 1, 1, 0, 0, 1, 1, 0, 0, 0, 1],
            [1, 2, 1, 1, 1, 1, 1, 1, 0, 1, 1, 0, 0, 0, 0, 1, 0, 1, 1, 0],
            [1, 2, 1, 0, 0, 1, 1, 0, 1, 1, 0, 0, 1, 1, 1, 0, 1, 0, 1, 0],
            [0, 2, 2, 2, 1, 0, 0, 0, 2, 2, 2, 0, 1, 0, 1, 1, 1, 1, 1, 0],
            [0, 1, 0, 2, 1, 1, 0, 1, 2, 0, 2, 1, 1, 0, 0, 0, 1, 1, 1, 0],
            [0, 1, 1, 2, 1, 0, 0, 1, 2, 1, 2, 0, 0, 1, 1, 0, 1, 1, 1, 0],
            [0, 0, 1, 2, 2, 2, 0, 1, 2, 1, 2, 1, 0, 0, 0, 0, 0, 1, 0, 0],
            [0, 1, 1, 1, 0, 2, 2, 2, 2, 1, 2, 1, 1, 1, 0, 1, 1, 1, 0, 0],
            [1, 1, 0, 0, 1, 0, 1, 0, 0, 0, 2, 1, 1, 0, 0, 0, 0, 0, 1, 1],
            [0, 1, 1, 1, 0, 1, 1, 1, 0, 1, 2, 2, 2, 2, 1, 0, 1, 1, 1, 1],
            [0, 0, 1, 0, 1, 1, 0, 1, 1, 1, 1, 0, 1, 2, 1, 0, 1, 1, 0, 1],
            [1, 0, 0, 0, 1, 1, 1, 0, 0, 0, 1, 1, 0, 2, 0, 1, 1, 1, 1, 0],
            [0, 0, 1, 0, 0, 0, 0, 0, 1, 0, 1, 1, 1, 2, 1, 0, 1, 1, 1, 1],
            [0, 0, 0, 0, 0, 0, 1, 0, 1, 0, 1, 1, 1, 2, 0, 1, 1, 1, 1, 0],
            [0, 0, 1, 0, 0, 0, 0, 1, 1, 1, 0, 1, 0, 2, 2, 2, 2, 2, 1, 1],
            [1, 0, 0, 1, 1, 0, 0, 1, 0, 0, 0, 0, 1, 0, 1, 0, 0, 2, 1, 0],
            [0, 1, 1, 0, 0, 0, 0, 1, 0, 1, 0, 1, 0, 1, 1, 1, 1, 2, 0, 0],
            [1, 0, 0, 0, 0, 0, 1, 0, 1, 0, 0, 0, 0, 0, 1, 0, 0, 2, 0, 1],
            [0, 1, 0, 0, 1, 1, 0, 0, 1, 0, 0, 1, 1, 0, 1, 1, 0, 2, 1, 0],
            [0, 1, 0, 0, 0, 1, 1, 1, 0, 0, 0, 1, 0, 0, 0, 0, 0, 2, 0, 0],
            [1, 0, 0, 0, 1, 1, 1, 0, 0, 1, 0, 0, 0, 1, 0, 1, 1, 2, 0, 0],
            [0, 0, 1, 1, 0, 1, 0, 1, 0, 0, 1, 1, 1, 1, 0, 1, 1, 2, 1, 1],
            [0, 1, 0, 1, 1, 0, 1, 0, 1, 0, 1, 0, 0, 1, 1, 0, 0, 2, 0, 0],
            [0, 1, 1, 1, 0, 0, 0, 0, 0, 0, 1, 1, 0, 0, 0, 1, 1, 2, 1, 0],
            [1, 0, 0, 1, 0, 1, 1, 1, 0, 1, 0, 0, 1, 0, 1, 0, 0, 2, 0, 0],
            [1, 1, 0, 1, 1, 1, 0, 0, 0, 0, 1, 0, 1, 0, 0, 0, 1, 2, 1, 0],
            [1, 1, 1, 0, 1, 1, 1, 1, 1, 0, 0, 0, 1, 1, 1, 1, 1, 2, 0, 0],
            [1, 0, 1, 1, 0, 1, 1, 1, 0, 1, 0, 0, 0, 0, 1, 0, 1, 2, 0, 0],
            [1, 0, 0, 0, 1, 0, 0, 0, 1, 0, 1, 1, 1, 0, 1, 0, 1, 2, 1, 1],
            [1, 1, 1, 1, 0, 1, 0, 1, 1, 1, 0, 1, 0, 0, 1, 1, 0, 2, 1, 0],
            [1, 0, 1, 0, 0, 1, 1, 0, 0, 1, 0, 0, 1, 0, 0, 1, 1, 2, 1, 0],
            [0, 0, 0, 1, 1, 1, 1, 1, 1, 1, 0, 0, 0, 1, 1, 1, 1, 2, 0, 0],
            [0, 1, 0, 1, 1, 1, 1, 0, 1, 1, 0, 1, 1, 0, 0, 1, 1, 2, 2, 2],
            [0, 0, 1, 1, 1, 0, 1, 0, 1, 0, 0, 1, 1, 1, 0, 1, 0, 0, 0, 2],
            [1, 1, 0, 1, 0, 0, 0, 1, 1, 1, 0, 1, 0, 1, 0, 0, 0, 1, 1, 2],
            [1, 1, 0, 1, 1, 1, 1, 1, 0, 1, 1, 0, 0, 1, 1, 0, 1, 2, 2, 2],
            [1, 1, 1, 1, 0, 0, 0, 1, 0, 0, 1, 0, 1, 1, 0, 0, 1, 2, 0, 1],
            [1, 1, 0, 0, 1, 0, 1, 0, 1, 1, 1, 1, 0, 0, 0, 1, 0, 2, 0, 0],
            [0, 1, 1, 0, 0, 1, 1, 1, 1, 1, 0, 0, 1, 1, 1, 0, 0, 2, 2, 2],
            [1, 0, 1, 0, 1, 0, 1, 0, 0, 0, 0, 0, 0, 0, 0, 0, 1, 1, 0, 9]
        ]
    }
]